NO ./texture/Beer.xpm
SO ./texture/ChickenLeg.xpm
EA ./texture/Sashimi.xpm
WE ./texture/MelonWater.xpm

F 200,100,0
C 225,30,0

1111
1001
1001
111          1111
             10N1
             111
